0,0,0,0,0,0,0,0,0,0
0,1,5,5,5,5,5,5,5,0
0,3,3,3,3,3,3,3,5,0
0,5,5,5,5,5,5,3,5,0
0,5,5,5,5,5,5,3,5,0
0,5,5,5,5,5,5,3,5,0
0,5,5,5,5,5,5,3,4,0
0,5,5,5,5,5,5,5,3,0
0,5,5,5,5,5,5,5,5,0
0,0,0,0,0,0,0,0,0,0
0,12,0,0,0,0,0,0,0,0