0,0,0,0,0,0,0,0,0,0
0,1,3,3,3,3,3,3,5,0
0,5,5,5,2,5,5,5,3,0
0,3,3,3,3,3,5,3,3,0
0,5,5,5,5,3,5,5,4,0
0,5,5,5,5,5,3,3,3,0
0,5,5,5,5,5,5,5,5,0
0,5,5,5,5,5,5,5,5,0
0,5,5,5,5,5,5,5,5,0
0,0,0,0,0,0,0,0,0,0
3,10,0,0,0,0,0,0,0,0