0,0,0,0,0,0,0,0,0,0
0,5,5,5,5,3,3,3,3,0
0,5,5,5,3,1,5,5,3,0
0,5,5,3,3,2,3,5,3,0
0,5,3,2,5,2,5,5,3,0
0,5,3,5,3,5,3,3,5,0
0,5,3,5,2,5,3,5,5,0
0,5,3,4,5,5,3,5,5,0
0,5,5,3,3,3,5,5,5,0
0,0,0,0,0,0,0,0,0,0
0,0,0,0,0,0,0,0,0,0
