0,0,0,0,0,0,0,0,0,0
0,5,5,5,5,5,3,3,3,0
0,5,5,5,3,3,5,5,1,0
0,5,5,3,5,2,5,3,3,0
0,5,5,5,3,5,2,5,3,0
0,5,5,3,5,2,5,3,3,0
0,5,5,5,3,5,2,5,3,0
0,5,5,5,3,3,5,3,5,0
0,5,5,5,5,3,5,4,3,0
0,0,0,0,0,0,0,0,0,0
1,0,0,0,0,0,0,0,0,0
