0,0,0,0,0,0,0,0,0,0
0,5,3,3,3,5,3,3,5,0
0,5,3,5,5,3,5,5,3,0
0,5,3,5,2,5,5,5,3,0
0,5,3,2,2,3,3,5,4,0
0,3,5,2,5,3,3,5,3,0
0,3,5,5,2,5,3,3,5,0
0,3,5,5,3,1,3,5,5,0
0,5,3,3,5,3,5,5,5,0
0,0,0,0,0,0,0,0,0,0
2,15,0,0,0,0,0,0,0,0