0,0,0,0,0,0,0,0,0,0
0,3,1,5,5,5,3,5,5,0
0,5,3,2,2,2,3,5,5,0
0,5,3,5,5,5,3,5,5,0
0,5,3,5,5,5,3,5,5,0
0,5,3,5,2,5,3,5,5,0
0,5,5,3,2,2,5,3,5,0
0,5,5,3,5,5,5,3,5,0
0,5,5,5,3,3,3,5,5,0
0,0,0,0,0,0,0,0,0,0
0,30,0,0,0,0,0,0,0,0