0,0,0,0,0,0,0,0,0,0
0,5,5,3,5,5,3,5,5,0
0,5,3,5,5,2,5,3,5,0
0,5,3,5,2,2,4,3,5,0
0,5,3,5,5,2,5,3,5,0
0,3,5,5,3,3,2,3,5,0
0,3,2,5,3,3,2,3,5,0
0,3,5,2,2,5,1,3,5,0
0,3,5,5,2,5,3,5,5,0
0,0,0,0,0,0,0,0,0,0
1,0,0,0,0,0,0,0,0,0